1:50
1:1,4:1,0:47,1:1
1:1,0:48,1:1
1:1,0:48,1:1
1:1,0:48,1:1
1:1,0:48,1:1
1:1,0:48,1:1
1:1,0:48,1:1
1:1,0:48,1:1
1:1,0:48,1:1
1:1,0:48,1:1
1:1,0:48,1:1
1:1,0:48,1:1
1:1,0:48,1:1
1:1,0:48,1:1
1:1,0:48,1:1
1:1,0:48,1:1
1:1,0:48,1:1
1:1,0:48,1:1
1:1,0:48,1:1
1:1,0:48,1:1
1:1,0:48,1:1
1:1,0:48,1:1
1:1,0:48,1:1
1:1,0:48,1:1
1:1,0:48,1:1
1:1,0:48,1:1
1:1,0:48,1:1
1:1,0:48,1:1
1:1,0:48,1:1
1:1,0:48,1:1
1:1,0:48,1:1
1:1,0:48,1:1
1:1,0:48,1:1
1:1,0:48,1:1
1:1,0:48,1:1
1:1,0:48,1:1
1:1,0:48,1:1
1:1,0:48,1:1
1:1,0:48,1:1
1:1,0:48,1:1
1:1,0:48,1:1
1:1,0:48,1:1
1:8,0:48,1:1
1:1,0:48,1:1
1:1,8:4,0:4,8:4,0:36,1:1
1:50